index	parameter_value
bootstrap	False
ccp_alpha	0.0
class_weight	
criterion	gini
max_depth	
max_features	auto
max_leaf_nodes	
max_samples	
min_impurity_decrease	0.0
min_impurity_split	
min_samples_leaf	1
min_samples_split	2
min_weight_fraction_leaf	0.0
n_estimators	100
n_jobs	-1
oob_score	False
random_state	123456
verbose	0
warm_start	False
